{
		"tileset" : "chemin.png",
		"terrain" : [
		
			[12,14,14,14,14,14,14,14,14, 14, 14, 14, 14,14,  16],
			[11, 2, 2, 2, 2, 2, 2, 2, 2,  2,  2,  2,  2, 2,   9],
			[11, 2, 10, 2,10, 2,10, 2,10,  2,  10,  2,  10, 2,   9],
			[11, 2, 2, 2, 2, 2, 2, 2, 2,  2,  2,  2,  2, 2,   9],
			[11, 2, 10, 2,10, 2,10, 2,10,  2,  10,  2,  10, 2,   9],
			[11, 2, 2, 2, 2, 2, 2, 2, 2,  2,  2,  2,  2, 2,   9],
			[11, 2, 10, 2,10, 2,10, 2,10,  2,  10,  2,  10, 2,   9],
			[11, 2, 2, 2, 2, 2, 2, 2, 2,  2,  2,  2,  2, 2,   9],
			[11, 2, 10, 2,10, 2,10, 2,10,  2,  10,  2,  10, 2,   9],
			[11, 2, 2, 2, 2, 2, 2, 2, 2,  2,  2,  2,  2, 2,   9],
			[11, 2, 10, 2,10, 2,10, 2,10,  2,  10,  2,  10, 2,   9],
			[11, 2, 2, 2, 2, 2, 2, 2, 2,  2,  2,  2,  2, 2,   9],
			[11, 2, 10, 2,10, 2,10, 2,10,  2,  10,  2,  10, 2,   9],
			[11, 2, 2, 2, 2, 2, 2, 2, 2,  2,  2,  2,  2, 2,   9],
			[8,6, 6, 6, 6, 6, 6, 6, 6,  6,  6,  6,  6, 6, 4]
		]
}